R  800 600
NO ./ressources/bonus/textures/tree_wall_snow.xpm
SO ./ressources/bonus/textures/tree_wall_snow.xpm
WE ./ressources/bonus/textures/tree_wall_snow.xpm
EA ./ressources/bonus/textures/tree_wall_snow.xpm
S ./ressources/bonus/textures/tree_snow.xpm
F 80 ,      65  , 174
C 186,110,31

111111111111111111111111111111111111
100000000000000000000000000000000001
120010000000200000000000000000000001
100010001000000000000000000000000001
100000000000000000000000000000000001
120202020200200000000000000000000001
100000000000000000000000000000000001
10000N000000000000000000011000000001
120000000000200000000000011100000001
100000000000000010000000000000000001
100000000000000010000000000002000001
100000000000001100000000000000020001
100000000001110000000010000200000001
100011000200002000001100000000200001
100001020002000000000000000000000001
100001000000002001000000000000000001
100000000200200000000000000010000001
102002000000000110000000000000100001
100000000002000000000000000000000001
111111111111111111111111111111111111



